@.........
..........
..........
.....#....
.....#....
..........
... ......
..........
..........
... .....*